=====#D#=====
===##...##===
==#.......#==
=#.........#=
=#.........#=
#...........#
D...........D
#...........#
=#.........#=
=#.........#=
==#.......#==
===##...##===
=====#D#=====