#####D######
#..........#
#..........#
D..........D
#..........#
#..........#
######D#####