####D####
#.......#
#.......#
=#.....#=
=D.....D=
=#.....#=
#.......#
#.......#
####D####