##D######
#.......#
D...#...D
#.......#
######D##