##D######
#.......#
D...#...D
#.......#
#.......#
#.......#
#.......#
#.......#
#.......#
#.......#
#.......#
#...#...#
#.......#
######D##